.PointProcessCC_RW	True
.PointProcessExtrema_RW	True
.PointProcessPeaks_RW	True
.PointProcessZeros_RW	True
.HarmonicityAC_RW	False
.HarmonicityCC_RW	False
.FormantSL_RW	False
.FormantBurg_RW	True
.LPCac_RW	False
.LPCBurg_RW	True
.LPCCovariance_RW	False
.LPCMarple_RW	False
.Silences_RW	False
.Intensity_RW	True
.MFCC_RW	True
.JitterLocal_RW	False
.JitterLocalAbsolute_RW	False
.JitterPPQ5_RW	False
.JitterRap_RW	False
.JitterDDP_RW	False
.ShimmerAPQ3_RW	False
.ShimmerAPQ5_RW	False
.ShimmerAPQ11_RW	False
.ShimmerLocal_RW	False
.ShimmerLocalDB_RW	False
.Pitch_RW	True
.PitchAC_RW	True
.PitchCC_RW	True
.PitchSHS_RW	True
.Sound_RW	False
